111111111111111111111
1CC00000000000C1CC1P1
1C1CCCCCCCCCCC11C11C1
11CC0000000000CCC1CC1
111C0000000CCC1111CC1
1CCCCCCCCCC00000CCCC1
1CCCCCCCCCC0000CCCCC1
1CCCCCCCC00CCCCCCCCC1
1111C1111CC00CCCCCCC1
1C00CCCEC1CCC00CCCCC1
111111111111111111111
