11111111111111
100000P0000001
10000111110001
10001000001001
1CCCCCCCCCCCE1
11111111111111
