111111111111111
100010101001011
100P00100000001
100000100000001
100C00100C00E01
111111111111111
