1111111111111
1P00000000001
1C10000000001
1100000000001
1110000000001
100000000C001
100000C000001
100C000000001
1001C1111C001
10010000E1001
1111111111111
