1111111111111111
1CC00000000001P1
1C1CCCCCC11C11C1
11C000000CCC1CC1
11C000CCC1111CC1
1CCCCC00000CCCC1
1CCCCC0000CCCEC1
1111111111111111
