111111111111111
100010101C01011
100P00100000001
10000C100100001
100C00100C10E01
111111111111111
