11111111111
10011111111
11111111111
