111111111111111111111111111111111
10000000000000000000000C000000001
10000P00000000000000000C000000E01
10000000000000000000000C000000001
10000000000000000000000C000000001
10000000000000000000000C000000001
111111111111111111111111111111111