1111111111111111111
100000000000C000001
1000000000000000001
1000000000011111001
1000000000010000001
100000C000010000001
100000000001000C001
1000011111111111111
1000000000000000001
1111111111111111111