111111111111111
100010101001011
100P00100000001
100000100100001
100C00100C10E01
111111111111111
