11111111111111111111111111111
100010000000C000001
1000100000000000001
1000100000011111001
1000111100010011101
100000C000010000001
100000000001000C001
1000011111111111011
1000000000000000CE1
1111111111111111111