1111111111
1P00C000C1
1111111101
1E0C00C001
1111111111
